111111111111
100000P01111
101111000001
100001000001
101C1000Y001
1E1100000001
111111111111