111111111111111111111
100000001100000000111
1C00C00C00C00C00C0P11
101111011111111111111
100000000000000000E11
111111111111111111111